########################
#L#         ###        #
# #    # ##     ###### #
#  ##### ########  ### #
#     ## #             #
#### #   #        # ####
#  #   #########    #  #
#  ######       #  #   #
#               #    #S#
########################